1111111
1010011
100N011
1100011
1111111
