NO tex/bric.xpm
SO tex/metal.xpm
EA tex/stone.xpm
WE tex/wood.xpm

F 0,0,10
C 10,0,0

111111111111111111111
101000001000000000001
101010101011111110001
100010100010000010001
111110101111101011101
100000101000101000001
101111101011101111111
100000001010100000101
100000011010111110101
111100001010100010101
100000001010101010101
100000001010001010001
100010001011111011101
100000101000100010001
100010101110101100111
100000100000100000001
100011111111100010001
100010000000000010001
100010111011111111101
1N0000001000000000001
111111111111111111111